#1 Пользователь вводит текст транслитом. Ваша задача - преобразовать текст в более-менее читабельный русский язык. Должны учитываться как буквы верхнего регистра, так и нижнего. 

Алфавит транслита:

a - a
b - б
v - в
g - г
d - д
e - е
yo - ё
j - ж
z - з
i - и
y - й
k - к
l - л
m - м
n - н
o - о
p - п
r - р
s - с
t - т
u - у
f - ф
h - x
c - ц
ch - ч
sh - ш
ey - э
yu - ю
ya - я

Пример: 
Privet, kak dela, Yulya? - Привет, как дела, Юля?
Chem zanyata segodnya? - Чем занята сегодня?